WE ./images/WE.xpm
SO ./images/SO.xpm  
EA ./images/EA.xpm
NO ./images/NO.xpm  

F 180,20,0


C 7,8,45

111111111111111111111
100000000000000000001
10000000000000N000001
100000000000000000001
100000000111000000001
100000000000000000001
100010000010000100001
1000000001 1001000011
100000000010000000001
100011100000000000001
100000000000000000001
111111111111111101111
111111111111111100111
111100000000000000001
111111111111011111111
111111111111011111111
100000000000000000001
111111111110000011111
111111111000000011111
111111111100000011111
111111111100000011111
111111111100010011111
111111111100000011111
111111111111111111111
